................
.#............#.
.#.########..#.
.#............#.
.####.......####
.#............#.
.#............#.
.#............#.
.####.#####.####
.#............#.
################
