................
.#.....###....#.
.#.####...#..#.
.#............#.
.####..###..####
.#............#.
.#............#.
.#............#.
.####.......####
.#............#.
################
